11111111111111111111111111111111111111111
10000000CCCCCPEEEECCCCCC00000000000001001
10000000000000000000000000000000000000001
10000000000000000000000000000000000000001
10000000000000000000000000000000000000011
10000000000000000000000000000000110000011
10000000000000000000000000000000000000011
10000000000000000000000000000000000000001
1CCCCC111CCC1111CCCC1111CCCCCEEEEEECCCCC1
1CCCCC111CCC1111CCCC1111CCCCCEEEEEECCCCC1
1CCCCC111CCC1111CCCC1111CCCCCEEEEEECCCCC1
1CCCCC111CCC1111CCCC1111CCCCCEEEEEECCCCC1
1CCCCC111CCC1111CCCC1111CCCCCEEEEEECCCCC1
1CCCCC111CCC1111CCCC1111CCCCCEEEEEECCCCC1
1CCCCC111CCC1111CCCC1111CCCCCEEEEEECCCCC1
1CCCCC111CCC1111CCCC1111CCCCCEEEEEECCCCC1
1CCCCC111CCC1111CCCC1111CCCCCEEEEEECCCCC1
1CCCCC111CCC1111CCCC1111CCCCCEEEEEECCCCC1
1CCCCC111CCC1111CCCC1111CCCCCEEEEEECCCCC1
1CC1CCC11CCC1111CCCC1111CCCCCEEEEEECCCCC1
11111111111111111111111111111111111111111