1111111111111111111
1000000000PCCCCEC01
1000000000000000001
1000001111000000001
100000CCC1000000001
1111111111111111111